# # # # # # # # # # # # # # # # # # # # # # # # # # # # # # # # # # # #
# x x x x x x x x T x # # x x x x x T > x x x # # x x x x x x x x x x #
# x x # x x x x # V x x x x ^ # x x x x # x x x x x x # ^ T > x # x x #
# x x x x x x x x x x x x x T x x x x x x T x x x x x x T x x T x x x #
# x ^ # x x x x # x x # # x x # x x x x # V x # # x x # x < T V # x x #
# x T x x x x x x x x # # x x x x x < T x x x # # x x x x x x x x x x #
# # x # # # # # # # # # # # # # # # # # # # # # # # # # # # # # # # # #
# # x # # # # # # # # # # # # # # # # # # # # # # # # # # # # # # # # #
# x x # T x x x x # T # # x x x x x x x x < T # # x x x x x x x x x x #
# < T # V x # x x # V x x x x x < T # # # x x # # x x # T > < T # x x #
# x x # x x # < T # x x x x x # # # # T # x x # # x x # # ^ ^ # # x x #
# x x # x ^ # x x # x # # x x # x x x V # ^ x # # x ^ x # T T # x ^ x #
# T > x x T # T > x x # # x x # T > x x x T x # # x T x # x x # x T x #
# # # # x x # # # # # # # # # # # x x # # # # # # # # # # x x # # # # #
# # # # x x # # # # # # # # # # # x x # # # # # # # # # # x x # # # # #
# x x # x x T > x x x # # T > x x x x x x < T # # x x x x x x # x x ^ #
# # x # # # # # # x ^ # # x x # ^ # # # # x x # # ^ x # # # # # # T T #
# x x < T x x x # T T x x x x x T # x x # x x x x T x # T > x x x V x #
# # # # # # x x # V x x x # # # T # # x # x x x x T # # x # # # # # # #
# x x x x x x x x x x # # x x x V x x x x < T # # V x x x x x x x < T #
# x x # # # # # # # # # # # # # # # # # # # # # # # # # # # # # # # # #
# x x # # # # # # # # # # # # # # # # # # # # # # # # # # # # # # # # #
# x x x x x x x x x x # # x x x x x x x x x x # # x x x x x x x x x x #
# x x x x x x x x x x # # x x x x x x x x x x # # x x # x x x x # x x #
# x x x x x x x x x x # # x x x x K x x x x x # # x x x x x x x x x x #
# x x x C x x x x x x # # x x x x x x x x x x # # x x # x x x x # x x #
# x x x x x x x x x x # # x x x x x x x x x x # # x x x x x x x x x x #
# # # # # # # # # # # # # # # # # # # # # # # # # # # # # # # # # # # #
# # # # # # # # # # # # # # # # # # # # # # # # # # # # # # # # # # # #
# x x x x x x x x x x # # x x x x x x x x x x # # x x x x x x x x x x #
# x x # x x x x # x x # # x x # x x x x # x x # # x x # x x x x # x x #
# x x x x x x x x x x # # x x x x x x x x x x # # x x x x x x x x x x #
# x x # x x x x # x x # # x x # x x x x # x x # # x x # x x x x # x x #
# x x x x x x x x x x # # x x x x x x x x x x # # x x x x x x x x x x #
# # # # # # # # # # # # # # # # # # # # # # # # # # # # # # # # # # # #
# # # # # # # # # # # # # # # # # # # # # # # # # # # # # # # # # # # #
# x x x x x x x x x x # # x x x x x x x x x x # # x x x x x x x x x x #
# x x # x x x x # x x # # x x # x x x x # x x # # x x # x x x x # x x #
# x x x x x x x x x x # # x x x x x x x x x x # # x x x x x x x x x x #
# x x # x x x x # x x # # x x # x x x x # x x # # x x # x x x x # x x #
# x x x x x x x x x x # # x x x x x x x x x x # # x x x x x x x x x x #
# # # # # # # # # # # # # # # # # # # # # # # # # # # # # # # # # # # #
# # # # # # # # # # # # # # # # # # # # # # # # # # # # # # # # # # # #
# x x x x x x x x x x # # x x x x x x x x x x # # x x x x x x x x x x #
# x x # x x x x # x x # # x x # x x x x # x x # # x x # x x x x # x x #
# x x x x x x x x x x # # x x x x x x x x x x # # x x x x x x x x x x #
# x x # x x x x # x x # # x x # x x x x # x x # # x x # x x x x # x x #
# x x x x x x x x x x # # x x x x x x x x x x # # x x x x x x x x x x #
# # # # # # # # # # # # # # # # # # # # # # # # # # # # # # # # # # # #
# # # # # # # # # # # # # # # # # # # # # # # # # # # # # # # # # # # #
# x x x x x x x x x x # # x x x x x x x x x x # # x x x x x x x x x x #
# x x # x x x x # x x # # x x # x x x x # x x # # x x # x x x x # x x #
# x x x x x x x x x x # # x x x x x x x x x x # # x x x x x x x x x x #
# x x # x x x x # x x # # x x # x x x x # x x # # x x # x x x x # x x #
# x x x x x x x x x x # # x x x x x x x x x x # # x x x x x x x x x x #
# # # # # # # # # # # # # # # # # # # # # # # # # # # # # # # # # # # #
# # # # # # # # # # # # # # # # # # # # # # # # # # # # # # # # # # # #
# x x x x x x x x x x # # x x x x x x x x x x # # x x x x x x x x x x #
# x x # x x x x # x x # # x x # x x x x # x x # # x x # x x x x # x x #
# x x x x x x x x x x # # x x x x x x x x x x # # x x x x x x x x x x #
# x x # x x x x # x x # # x x # x x x x # x x # # x x # x x x x # x x #
# x x x x x x x x x x # # x x x x x x x x x x # # x x x x x x x x x x #
# # # # # # # # # # # # # # # # # # # # # # # # # # # # # # # # # # # #
# # # # # # # # # # # # # # # # # # # # # # # # # # # # # # # # # # # #
# x x x x x x x x x x # # x x x x x x x x x x # # x x x x x x x x x x #
# x x # x x x x # x x # # x x # x x x x # x x # # x x # x x x x # x x #
# x x x x x x x x x x # # x x x x x x x x x x # # x x x x x x x x x x #
# x x # x x x x # x x # # x x # x x x x # x x # # x x # x x x x # x x #
# x x x x x x x x x x # # x x x x x x x x x x # # x x x x x x x x x x #
# # # # # # # # # # # # # # # # # # # # # # # # # # # # # # # # # # # #
